........................
........................
..####....####....####..
..#..#....#..#....#..#..
..#..#....#..#....#..#..
..####....####....####..
........................
........................
..####....####....####..
..#..#....#..#....#..#..
..#..#....#..#....#..#..
..####....####....####..
........................
........................
..####....####....####..
..#..#....#..#....#..#..
..#..#....#..#....#..#..
..####....####....####..
........................
........................
........................
........................
........................
