........................................
........................................
..##......##......##......##......##....
..##......##......##......##......##....
........................................
........................................
......##......##......##......##........
......##......##......##......##........
........................................
........................................
..##......##......##......##......##....
..##......##......##......##......##....
........................................
........................................
......##......##......##......##........
......##......##......##......##........
........................................
........................................
..##......##......##......##......##....
..##......##......##......##......##....
........................................
........................................
......##......##......##......##........
......##......##......##......##........
........................................
........................................
..##......##......##......##......##....
..##......##......##......##......##....
........................................
........................................
......##......##......##......##........
......##......##......##......##........
........................................
........................................
........................................
........................................
........................................
........................................
