..........
..........
...####...
...#..#...
...#..#...
...####...
..........
..........
..........
..........
